#####x###
#.......#
#.......#
#.......#
#.......#
#.......#
x.......#
#.......#
##x######
