####x####
#.......#
#.......#
#.......#
#.......x
#.......#
#ee.....#
#Ke.....#
#########
