###########x#############
#.......................#
#.......................#
#.... ....   #..........#
#.... ..... .#..........#
#.... ......#...........#
#.... .....#............#
#.... ....#.............#
#..................E....#
#............ ..........#
X............. .........x
#.............. ........#
#............... .......#
#..... .......... ......#
#...... .......... .....#
#....... .......... ....#
#................ .. ...#
#........ .......... ...#
#......... .......... ..#
#.......... ......... ..#
#...........  ....... ..#
#..............  ... ...#
#............. .... ....#
#.......................#
#########################
