#########################
#.......................#
#.......................#
#.......................#
#... .....####..........#
#... .....#..#..........#
#... .....#      .......#
#... .           .......#
#... ....        .......#
#.......................#
x......EEEEEEEE.........X
#.......................#
#.......................#
#.......................#
#...             .......#
#.......................#
#....            .......#
#.......................#
#.......................#
#.......................#
#.......................#
#.......................#
#.....           .......#
#.......................#
#########################
