#########################
#.......................#
#.......................#
#.......................#
#.......................#
#...........###..   ....#
#............#....  ....#
#...........###..   ....#
#.......................#
#.......................#
#....           ........X
#.......................#
#.......................#
#...............e.......#
#................e......#
#.................e.....#
#..................e....#
#...................e...#
#....................e..#
#.......................#
#.......................#
#.......................#
#.......................#
#.......................#
##############x##########
