#########################
#.......................#
#.......................#
#.......................#
#..................    .#
#.......................#
#.......................#
#..........   ..........#
#.......................#
#.......................#
X..   ..................#
#...............  ......#
#.......................#
#.......................#
#.......  ..............#
#.......................#
#...............  ......#
#.......................#
#.....   ...............#
#.................     .#
#.......................#
#.....   ...............#
#.......................#
#.......................#
##############x##########
