###########x#############
#.......................#
#.......................#
#.......................#
#.........####..........#
#.........#..#..........#
#.........####..........#
#............#..........#
#.........####..........#
#.......................#
#.......................#
#......####.............#
#......#..#.............#
#......####.............#
#.........#.............#
#......####.............#
#.......................#
#...........E...####....#
#...............#..#....#
#...............####....#
#..................#....#
#...............####....#
#.......................#
#...........E...........#
##############x##########
