#########################
#.......................#
#.......................#
#.......................#
#.......................#
#.......................#
#.......................#
#.......................#
#.......................#
#.........# #.#.........#
#.......................#
#.......................#
#.......................#
x.......................#
#.......................#
#.......................#
#.............@.........#
#.......................#
#.......................#
#.......................#
#.......................#
#.......................#
#.......................#
#.......................#
#########################
